SSSSSSSSSGGSSSSSSSSS
SwwwS..........SwwwS
SwwwS..........SwwwS
SwwwS..........SwwwS
SSDSS..........SSDSS
S..................S
S..................S
S..................S
S..................S
S..................S
S..................S
S..................S
S..................S
S..................S
S..................S
SSDSS..........SSDSS
SwwwS..........SwwwS
SwwwS..........SwwwS
SwwwS..........SwwwS
SSSSSSSSSGGSSSSSSSSS